EA ./farasha.png
NO ./farasha.png
SO ./farasha.png
WE ./farasha.png

F 255,255,145
C 145,1,20


1111111111111111111
1000000000000000001
1001110000100011111
1001110000100011111
1001110000100011111
1001110000100011111
1001110000000011111
1001110000N00011111
1001110000000011111
1001110000100011111
1001110000100011111
1001110000100011111
1001110000100011111
1001110000100011111
1001110000100011111
1001110000100011111
1001110000100011111
100000000000001
100000000000001
111111111111111


