EA ./libft/Makefile
NO ./Makefile 
SO ./libft/ft_bzero.c
WE ./libft/ft_isdigit.c

F 1,1,1
C 225,30,0 


111111111111111
100000000000001
100111000010001
100100000010001
100100000010001
100100000010001
100100100001001
100000000000001
100000000000001
100000000000001
100000000000001
100000000000001
10S000000000001
100000000000001
111111111111111


