EA ./mok.png
NO ./mok.png
SO ./mok.png
WE ./mok.png

F 102,102,0
C 102,0,0


1111111111111111111
1000000000000000001
1001110000111110111
1001110000100N10111
1001110000100010111
1001110000100010111
1001110000000000111
1001110000000011111
1001110000000011111
1001110000100011111
1001110000100011111
1001110000100011111
1001110000100011111
1001110000100011111
1001110000100011111
1001110000100011111
1001110000100011111
100000000000001
100000000000001
111111111111111


