NO ./Makefile 
SO ./libft/ft_bzero.c
WE 

F       1,1,1
C 225,30,0   

EA ./libft/Makefile









1111111111
1
1
1
        1111111111111111111111111             1
        1111111111  111111111                11
        100000000011000000001   1111111       1
        1011000001110000000001111
        1001000000000000000000001
111111111011000001110000000000001
100000000011000001110111111111111
11110111111111011100000010001
11110111111111011100000010001
11110111111111011100000010001
11110111111111011100000010001
11110111111111011100000010001
11110111111111011100000010001
11110111111111011100000010001
11110111111111011100000010001
11110111111111011100000010001
11110111111111011100000010001
11110111111111011100000010001
11110111111111011100000010001
11110111111111011100000010001
11110111111111011100000010001
11110111111111011100000010001
11110111111111011100000010001
11110111111111011100000010001
11110111111111011100000010001
11110111111111011100000010001
11110111111111011100000010001
11110111111111011100000010001
11110111111111011100000010001
11110111111111011100000010001
11110111111111011100000010001
11110111111111011100000010001
11110111111111011100000010001
11110111111111011100000010001
11110111111111011100000010001
11110111111111011100000010001
11110111111111011100000010001
11110111111111011100000010001
11110111111111011100000010001
11110111111111011100000010001
11110111111111011100000010001
11110111111111011100000010001
11110111111111011100000010001
11110111111111011100000010001
11110111111111011100000010001
11110111111111011100000010001
11110111111111011100000010001
11110111111111011100000010001
11110111111111011100000010001
11110111111111011100000010001
11110111111111011100000010001
11110111111111011100000010001
11110111111111011100000010001
11110111111111011100000010001
11110111111111011100000010001
11110111111111011100000010001
11110111111111011100000010001
11110111111111011100000010001
11110111111111011100000010001
11110111111111011100000010001
11110111111111011100000010001
11110111111111011100000010001
11110111111111011100000010001
11110111111111011100000010001
11110111111111011100000010001
11110111111111011100000010001
11110111111111011100000010001
11110111111111011100000010001
11110111111111011100000010001
11110111111111011100000010001
11110111111111011100000010001
11110111111111011100000010001
11110111111111011100000010001
11110111111111011100000010001
11110111111111011100000010001
11110111111111011101010010001
11000000110101011100000010001 
10000000000000001100000010N01
10000000000000001101010010001
11000001110101011111011110111
11110111 1110101 101111010001
11111111 1111111 11111111111

