EA ./mok.png
NO ./mok.png
SO ./mok.png
WE ./mok.png

F 255,36,255
C 40,36,255


1111111111111111111
1000000000000000001
1001110000111111111
1001110000100N11111
1001110000100011111
1001110000100011111
1001110000000011111
1001110000000011111
1001110000000011111
1001110000100011111
1001110000100011111
1001110000100011111
1001110000100011111
1001110000100011111
1001110000100011111
1001110000100011111
1001110000100011111
100000000000001
100000000000001
111111111111111


