F 220,90,10
NO ./path_to_the_north_texture
SO ./path_to_the_south_texture
C 225,30,0
WE ./path_to_the_west_texture
EA


1111111111111111111111111
1N1
11111111111111111111111111












